1111111
1001E01
1111111
1P000C1
1111111