1111111
1001P01
1111111
1E000C1
1111111