1111111
1001C01
1111111
1E000P1
1111111