1111111111111111111111111111111111111111111111111111111111111111111111111111111111111111111111111111
100000000000000000000000000000000C00000C0C0CCC0000000000000000000000010000000C1100000000000000000001
1000000000000000000000000000000000000000000000000000000000000000000000000000000000000000000000000001
100000000000000000000000000000000000000000000000000000000000000000000000000000000000000CC00000000001
110000000000000000000111111111111111111111111111000000000000000000000000P000000000000000000000000011
1000000000000000000000001111111111110000000000000000000000000000000000000000000000000000000000000001
1111111111110000000000000000000000000000000000000000000000000000000000000000000000000000000000000001
111111110000000000000000000000000000000000000000000000C000000000000000000000000000000111111111111111
1110000000000000000000000000111110000000001000000000000000000001000000000000000000000000000000011111
11000000100CC000000001011111111111111000000000000000000000000000000000000010000000000011000000010111
11111110100CE000000011111010000000000000000000000000000000000000000000000000000000000000000000000111
1111110000000000000000000000000000000110000000000000000011111000000000000000000000000000000000001111
100000000000000000000000000000000C00000C0C0CCC0000000001111111111000010000000C1100000000000000000001
1000000000000000000000000000000000000000000000000000000000000000000000000000000000000000000000000001
1000000000000000000000000000000000000000000000000000000000000000000000000000000000000000000000000001
1100000000000000000000000000100000000000000000000000000000000000000000001000000000000000000000000011
10000000000000000000000000000000000000000000000000000C0000000000000000000000000000000000000000000001
1111111111110000000000000000000000000000000000000000000000000000000000000000000000000000000000000001
1111111100000000000000000000000000000000000000000000000000000000000000000000000000000111111111111111
1110000000000000000000000000100000000000001000000000000000000001000000000000000000000000000000011111
1100000010000000000001011111111111111000000000000000000000000000000000000010000000000011000000010111
1111111010011110000011111010000000000000000000000000000000000000000000000000000000000000000000000111
1111110000000000000000000000000000000110000000000000000011111000000000000000000000000000000000001111
1000000000000000CC000000000000000C00000C0C0CCC0000000000000000000000010000000C1100000000000000000001
1000000000000000000000000000000000000000000000000000000000000000000000000000000000000000000000000001
1000000000000000000000000000000000000000000000000000000000000000000000000000000000000000000000000001
1100000000000000000000000000000000000000000000000000000001111111111111111111111000000000000000000011
100000000000000000000000000000C000000000000000000000000000000000000000000000000000000000000000000001
1111111111110000000000000000000000000000000000000000000000000000000000000000000000000000000000000001
1111111100000000000000000000000000000000000000000000000000000000000000000000000000000111111111111111
1110000000000000000001111111111111110000001000000000000000000001000000000000000000000000000000011111
1100000010000000000001011111111111111000000000000000000000000000000000000010000000000011000000010111
1111111010010000001111111110000000000000000000000000000000000000000000000000000000000000000000000111
1111110000000000000000000000000000000110000000000000000011111000000000000000000000000000000000001111
100000000000000000000000000000000C00000C0C0CCC0000000000000000000000010000000C1100000000000000000111
1000000000000000000000000000000000000000000000000000000000000000000000000000000000000000000000000011
1000000000000000000000000000000000000000000001111110000000000000000000000000000000000000000000000011
1100000000000000000000000000000000000000000000000000000000000000000011111100000000000000000000000011
1000000000000000000000000000000000000000000C00000000000000000000000000000000000000000000000000000001
1111111111110000000000000000000000000000000000000000000000000000000000000000000000000000000000000001
11111111000000000000000000000000000000000000000000000000000000000000000000000CC000000111111111111111
1110000000000000000000000000100000000000001000000000000000010001000000000000000000000000000000011111
1100000010000000000001011111111111111000000000000000000000111000000000000010000000000011000000010111
1111111010010000011111111110000000000000000000000000000001111100000000000000000000000000000000000111
1111111111111110000000000000000000000110000000000000000011111110000000000000000000000001111111111111
1111111111111111111111111111111111111111111111111111111111111111111111111111111111111111111111111111