111111111111111111111110
11111000000000E001111111
111111111CCCCCC111111111
0111111111P0000111111111
11111111111111111111111