11111111
10000001
100EPC01
10000001